MAP
__[|) A (|]_________
__|          |______
_| ____    ~      |_
_|        _____   |_
__|               |_
__|            ~  |_
_|   ``` `` ``   |__
_|                |_
____|    ~        |_

 ["]'''["]'''}}}
 ||_||_||_||_}}}
 ||_||_||_||_}}}
